---------------------
-   -     -   -     p
-----  -  - - - -----
-   -  -  - - - -   p
-   -  -  - - - -  --
/   -  -  - - -    --
-   -  -  - - - -----
-   -  -    - - -   *
-   -  -  ---   -   -
--/--  -     -l--   t
-      -            -
---------------------

SimpleTomato
SimpleLettuce

3 6
6 1
2 10
8 2