-c------=
-       ?
/   -   -
-   -   *
-   -   -
-       p
--P--p---

SimplePizza

7 2
1 3
1 5
3 4